Seraphine	seraphine
Samira	samira
Yone	yone
Lillia	lillia
Sett	sett
Aphelios	aphelios
Senna	senna
Qiyana	qiyana
Yuumi	yuumi
Sylas	sylas
Neeko	neeko
Nunu	nunu
Nunu & Willump	nunu
Fizz	fizz
Akali	akali
Pyke	pyke
Kai'Sa	kaisa
Zoe	zoe
Aatrox	aatrox
Ahri	ahri
Alistar	alistar
Amumu	amumu
Anivia	anivia
Annie	annie
Ashe	ashe
Aurelion Sol	aurelionsol
Aurelion	aurelionsol
Sol	aurelionsol
Azir	azir
Bard	bard
Blitzcrank	blitzcrank
Brand	brand
Caitlyn	caitlyn
Cassiopeia	cassiopeia
Cho'Gath	chogath
Corki	corki
Darius	darius
Diana	diana
Dr. Mundo	drmundo
Mundo	drmundo
Draven	draven
Ekko	ekko
Elise	elise
Evelynn	evelynn
Ezreal	ezreal
Fiddlesticks	fiddlesticks
Fiora	fiora
Galio	galio
Gangplank	gangplank
Garen	garen
Gnar	gnar
Gragas	gragas
Graves	graves
Hecarim	hecarim
Heimerdinger	heimerdinger
Irelia	irelia
Janna	janna
Jarvan IV	jarvaniv
Jarvan	jarvaniv
Jax	jax
Jayce	jayce
Jinx	jinx
Kalista	kalista
Karma	karma
Karthus	karthus
Kassadin	kassadin
Katarina	katarina
Kayle	kayle
Kennen	kennen
Kha'Zix	khazix
Kindred	kindred
Kog'Maw	kogmaw
LeBlanc	leblanc
LeeSin	leesin
Lee Sin	leesin
Lee	leesin
Leona	leona
Lissandra	lissandra
Lucian	lucian
Lulu	lulu
Lux	lux
Malphite	malphite
Malzahar	malzahar
Maokai	maokai
Master Yi	masteryi
Yi	masteryi
Miss Fortune	missfortune
Fortune	missfortune
Mordekaiser	mordekaiser
Morgana	morgana
Nami	nami
Nasus	nasus
Nautilus	nautilus
Wukong	wukong
Nidalee	nidalee
Nocturne	nocturne
Olaf	olaf
Orianna	orianna
Pantheon	pantheon
Poppy	poppy
Quinn	quinn
Rammus	rammus
Rek'Sai	reksai
Renekton	renekton
Rengar	rengar
Riven	riven
Rumble	rumble
Ryze	ryze
Sejuani	sejuani
Shaco	shaco
Shen	shen
Shyvana	shyvana
Singed	singed
Sion	sion
Sivir	sivir
Skarner	skarner
Sona	sona
Soraka	soraka
Swain	swain
Syndra	syndra
TahmKench	tahmkench
Tahm Kench	tahmkench
Tahm	tahmkench
Kench	tahmkench
Talon	talon
Taric	taric
Teemo	teemo
Thresh	thresh
Tristana	tristana
Trundle	trundle
Tryndamere	tryndamere
Twisted Fate	twistedfate
Twitch	twitch
Udyr	udyr
Urgot	urgot
Varus	varus
Vayne	vayne
Veigar	veigar
Vel'Koz	velkoz
Vi	vi
Viktor	viktor
Vladimir	vladimir
Volibear	volibear
Warwick	warwick
Xerath	xerath
Xin Zhao	xinzhao
Yasuo	yasuo
Yorick	yorick
Zac	zac
Zed	zed
Ziggs	ziggs
Zilean	zilean
Zyra	zyra
Ornn	ornn
Rakan	rakan
Xayah	xayah
Kayn	kayn
Kled	kled
Braum	braum
Camille	camille
Illaoi	illaoi
Ivern	ivern
Jhin	jhin
Taliyah	taliyah
Rell	rell
